1 1 1 1 3 1 3 1 1 3 1 1 1 1 1 1 1 1 1 1 1 1 1 1 1 1 1 1 1 1 1 1
1 0 0 0 0 0 0 0 0 0 0 0 0 0 0 0 0 0 0 0 0 0 0 0 0 0 0 0 0 0 0 1
1 0 1 1 1 1 1 1 1 1 1 1 1 1 1 1 1 1 1 1 1 1 1 1 1 1 1 1 1 1 0 1
1 0 1 1 1 1 1 1 1 1 1 1 1 1 1 1 1 1 1 1 1 1 1 1 1 1 1 1 1 1 0 1
1 0 1 1 1 1 1 1 1 1 1 1 1 1 1 1 1 1 1 1 1 1 1 1 1 1 1 1 1 1 0 1
1 0 1 1 1 1 1 1 1 1 1 1 1 1 1 1 1 1 1 1 1 1 1 1 1 1 1 1 1 1 0 1
1 0 1 1 1 1 1 1 1 1 1 3 1 1 1 1 1 1 1 1 1 1 1 1 1 1 1 1 1 1 0 1
1 0 1 1 1 1 1 1 1 3 1 1 1 1 1 1 1 1 3 1 1 1 1 1 1 1 1 1 1 1 0 1
1 0 1 1 1 1 1 1 3 1 1 3 1 1 1 3 1 3 1 1 1 1 1 1 1 1 1 1 1 1 0 1
1 1 1 1 1 1 3 1 1 1 1 1 3 1 3 1 1 1 3 3 1 1 3 1 1 1 1 1 1 1 0 1
1 1 1 1 1 1 1 3 1 2 0 0 0 0 2 1 1 0 2 0 0 0 1 1 1 1 1 1 1 1 1 1
1 1 1 1 1 1 1 1 3 2 2 0 3 1 0 1 1 0 1 3 0 0 1 1 1 1 1 1 1 1 1 1
1 0 0 0 0 0 0 0 2 2 0 0 1 3 0 1 1 2 1 3 0 2 0 0 0 0 0 0 0 0 0 1
1 0 0 0 0 0 2 0 0 0 0 0 1 1 0 1 1 2 1 1 0 2 0 0 0 0 0 0 0 0 0 1
1 0 0 0 0 2 0 0 0 0 0 0 1 1 5 0 0 4 1 1 0 0 0 0 0 0 0 0 0 0 1 1
1 2 2 2 2 0 0 0 0 2 0 0 1 3 V 3 1 V 1 1 0 0 2 0 0 0 0 0 0 0 O 1
1 0 0 0 0 0 0 0 0 2 0 0 1 1 V 1 1 V 1 1 0 0 0 0 0 0 0 0 0 0 1 1
1 0 0 0 2 2 0 0 0 0 0 0 1 1 4 0 0 5 3 3 0 0 0 0 0 0 0 0 0 0 0 1
1 0 0 0 0 0 0 0 0 0 0 0 3 1 0 1 1 0 1 1 0 0 0 0 0 0 0 0 0 0 0 1
1 0 0 2 2 0 0 0 0 0 0 0 3 1 0 1 1 0 1 1 0 2 0 0 0 0 0 0 0 0 0 1
1 1 1 1 3 1 1 3 3 0 0 0 1 1 0 1 1 0 1 3 0 0 0 1 1 1 1 1 1 1 1 1
1 1 1 1 1 1 1 1 3 0 0 0 0 0 0 1 1 0 0 0 0 0 0 1 1 1 1 1 1 1 0 1
1 1 1 1 1 1 1 1 1 1 3 1 1 1 3 1 1 3 1 1 1 1 1 1 1 1 3 1 1 1 0 1
1 0 1 1 1 1 1 1 1 1 1 1 1 1 1 1 1 1 1 1 1 1 1 1 1 1 1 1 1 1 0 1
1 0 1 1 1 1 1 1 1 1 1 1 1 1 1 1 1 1 1 1 1 1 1 1 1 1 1 1 1 1 0 1
1 0 1 1 1 1 1 1 1 1 1 1 1 1 1 1 1 1 1 1 1 1 1 1 1 3 1 1 1 1 0 1
1 0 1 1 1 1 1 1 1 1 1 1 1 1 1 1 1 1 1 1 1 1 1 3 1 1 1 1 1 1 0 1
1 0 1 1 1 1 1 1 1 1 1 1 1 1 1 1 1 1 1 1 1 1 1 1 1 1 1 1 1 1 0 1
1 0 1 1 1 1 1 1 1 1 1 1 1 1 1 1 1 1 1 1 1 1 1 1 1 1 1 1 1 1 0 1
1 0 1 1 1 1 1 1 1 1 1 1 1 1 1 1 1 1 1 1 1 1 1 1 1 1 1 1 1 1 0 1
1 0 0 0 0 0 0 0 0 0 0 0 0 0 0 0 0 0 0 0 0 0 0 0 0 0 0 0 0 0 0 1
1 1 1 1 1 1 1 1 1 1 1 1 1 1 1 1 1 1 1 1 1 1 1 1 1 1 1 1 1 1 1 1


