3 3 3 3 3 3 3 3 3 3 3 3 3 3 3 3 3 3 3 1 1 1 1 1 1 1 1 1 1 1 1 1
1 0 0 0 0 3 3 0 3 3 0 0 0 0 1 0 1 1 0 0 0 0 0 3 3 0 3 3 0 0 0 1
1 0 0 0 0 3 0 0 0 3 0 0 0 0 0 0 0 0 0 0 0 0 0 3 0 0 0 3 0 0 0 1
1 0 0 0 0 3 0 0 0 3 0 1 3 1 1 0 0 0 1 1 1 1 0 3 0 0 0 3 0 0 0 1
1 0 0 0 0 3 3 0 3 3 0 0 0 0 1 1 3 3 1 0 0 0 0 3 3 0 3 3 0 0 0 1
1 0 0 0 0 0 3 0 3 0 0 3 1 1 1 0 1 0 3 3 3 1 0 0 3 0 3 0 0 0 0 1
1 0 0 0 0 1 0 0 0 0 0 0 0 0 1 1 1 1 1 0 0 0 0 0 0 0 0 0 0 0 0 1
1 0 0 0 1 0 0 1 1 1 0 0 0 0 1 0 0 0 1 0 0 1 3 0 0 0 3 3 3 3 0 1
1 0 0 0 0 1 0 0 0 0 0 0 0 0 1 0 0 0 1 0 0 0 3 1 0 0 3 0 0 3 0 1
1 0 0 0 0 0 0 0 0 0 0 0 0 0 1 0 0 0 1 0 0 0 0 0 0 0 3 0 0 3 0 1
1 0 0 0 3 0 3 3 0 0 0 0 0 0 1 1 1 1 1 0 0 0 0 0 0 0 3 0 0 3 0 1
1 0 0 0 0 0 0 0 0 0 0 3 3 3 3 1 1 1 3 3 3 3 0 0 0 0 3 3 3 3 0 1
1 0 0 0 0 0 0 0 0 0 0 1 0 0 0 0 0 0 0 0 0 1 0 0 0 0 0 0 0 0 0 1
1 0 0 0 0 0 0 0 0 0 0 1 0 4 0 0 0 0 0 4 0 3 0 0 0 0 0 3 3 3 3 1
1 1 0 0 0 0 1 0 0 1 0 1 0 0 g g g g g 0 0 1 0 0 0 0 3 3 0 0 3 1
1 0 0 0 0 0 0 0 0 0 0 1 0 0 g 0 0 0 g 0 0 1 0 0 0 0 0 0 0 0 0 1
1 1 0 0 0 0 1 0 0 0 0 1 0 0 g 0 0 0 g 0 0 1 0 0 0 0 3 3 0 0 1 1
1 0 0 0 0 1 0 0 0 0 0 1 0 0 g 0 0 0 g 0 0 1 0 0 0 0 0 3 3 3 3 1
1 0 0 0 0 0 0 0 0 0 0 1 0 0 g g g g g 0 0 1 0 0 0 0 0 0 0 0 0 1
1 0 0 0 1 0 0 0 0 0 0 1 0 0 0 0 0 0 0 0 0 1 0 0 0 0 0 0 0 0 0 1
1 1 1 1 1 0 0 1 1 3 1 3 0 0 4 0 0 0 4 0 0 1 0 0 1 0 0 0 0 0 0 1
1 0 0 0 0 1 1 1 0 0 1 1 1 1 1 1 5 1 1 1 1 1 0 0 0 0 0 1 0 0 0 1
1 0 0 0 0 0 0 0 0 0 0 1 0 0 0 0 0 3 0 0 0 0 0 1 0 1 3 0 0 0 0 1
1 0 0 0 0 0 0 0 0 0 0 1 0 0 0 4 0 3 0 0 1 0 0 0 0 0 0 0 0 0 0 1
1 0 0 0 0 0 0 0 0 0 0 1 5 1 1 3 1 1 0 0 1 0 1 1 0 0 0 0 0 0 0 1
1 0 0 0 0 0 0 0 0 0 0 0 0 0 0 0 0 0 0 0 0 0 0 0 0 0 0 0 0 0 0 1
1 0 0 0 0 0 1 0 1 0 0 0 0 0 1 1 1 1 1 0 0 0 0 0 1 0 1 0 0 0 0 1
1 0 0 0 0 1 1 0 1 1 0 0 0 0 1 0 0 0 1 0 0 0 0 1 1 0 1 1 0 0 0 1
1 0 0 1 0 1 0 0 0 1 0 0 3 1 1 0 0 0 1 1 1 0 0 1 0 0 0 1 0 0 0 1
1 0 1 0 0 1 0 0 0 1 0 1 3 0 1 0 0 0 1 0 1 1 0 1 0 0 0 1 0 0 0 1
1 0 0 0 0 1 1 0 1 1 0 0 0 0 1 1 1 1 1 0 0 0 0 1 1 0 1 1 0 0 0 1
3 3 3 3 3 3 3 3 3 3 3 3 3 3 3 3 3 3 3 1 1 1 1 1 1 1 1 1 1 1 1 1

