3 3 3 3 3 3 3 3 3 3 3 3 3 3 3 3 3 3 3 1 1 1 1 1 1 1 1 1 1 1 1 1
1 0 0 0 0 3 3 4 3 3 0 0 0 0 1 0 1 1 0 0 0 0 0 3 3 4 3 3 0 0 0 1
1 0 0 0 0 3 0 0 0 3 0 0 0 0 0 0 0 0 0 0 0 0 0 3 0 0 0 3 0 0 0 1
1 0 0 0 0 3 0 0 0 V 0 H H H H 0 0 0 H H H H 0 V 0 0 0 3 0 0 0 1
1 0 0 0 0 3 3 0 V H 0 0 0 0 V H H H V 0 0 0 0 H V 0 3 3 0 0 0 1
1 0 0 0 0 0 3 5 H 0 0 H H H H 0 1 0 H H H V 0 0 H 5 3 0 0 0 0 1
1 0 0 0 0 1 0 0 0 0 0 0 0 0 1 1 1 1 1 0 0 0 0 0 0 0 0 0 0 0 0 1
1 0 0 0 1 0 0 0 0 1 0 1 0 0 1 0 0 0 1 0 0 H V 0 0 0 3 3 3 3 0 1
1 0 0 0 0 1 0 4 1 1 1 1 0 0 1 0 0 0 1 0 0 0 H H 0 4 3 0 0 3 0 1
1 0 0 0 0 0 0 0 0 0 0 0 0 0 1 0 0 0 1 0 0 0 0 0 0 0 3 0 0 3 0 1
1 0 0 0 3 0 3 3 0 0 0 0 0 0 1 1 1 1 1 0 0 0 0 0 0 0 3 0 0 3 0 1
1 0 0 0 0 0 0 0 0 0 0 3 3 3 3 1 1 1 3 3 3 3 0 0 0 0 3 3 3 3 0 1
1 0 0 0 0 0 0 0 0 0 0 1 4 H H H H H H H 4 1 0 0 0 0 0 0 0 0 0 1
1 0 0 0 0 0 0 0 0 0 0 1 0 0 0 0 V 0 0 0 0 3 0 0 0 0 0 3 3 3 3 1
1 1 0 0 0 0 1 0 0 1 0 1 0 0 0 F V F 0 0 0 1 0 0 0 0 3 3 0 0 3 1
1 0 0 0 0 0 0 0 0 0 0 1 0 0 J 0 0 0 I 0 0 1 0 0 0 0 0 0 0 0 0 1
1 1 0 0 0 0 1 0 0 0 0 1 0 0 J 0 0 0 I 0 0 1 0 0 0 0 3 3 0 0 1 1
1 0 0 0 0 1 0 0 0 0 0 1 0 0 J 0 0 0 I 0 0 1 0 0 0 0 0 3 3 3 3 1
1 0 0 0 0 0 0 0 0 0 0 1 0 0 0 K K K 0 0 0 1 0 0 0 0 0 0 0 0 0 1
1 0 0 0 1 0 0 0 0 0 0 1 0 0 0 0 0 0 0 0 0 1 0 0 0 0 0 0 0 0 0 1
1 1 1 1 1 0 0 1 1 3 1 3 0 0 4 0 0 0 4 0 0 1 0 0 1 0 0 0 0 0 0 1
1 0 0 0 0 1 1 1 0 0 1 1 1 1 H H 5 H H 1 1 1 0 0 0 0 0 1 0 0 0 1
1 0 0 0 0 0 0 0 0 0 0 1 0 0 0 0 0 V 0 0 0 0 0 1 0 1 3 0 0 0 0 1
1 0 0 0 0 0 0 4 0 0 0 1 0 0 0 4 0 V 0 0 1 0 0 0 0 0 0 0 0 0 0 1
1 0 0 0 0 0 0 0 0 0 0 1 5 1 1 3 H 1 0 0 1 0 1 1 0 4 0 0 0 0 0 1
1 0 0 0 0 0 0 0 0 0 0 0 0 0 0 0 0 0 0 0 0 0 0 0 0 0 0 0 0 0 0 1
1 0 0 0 0 0 1 5 1 0 0 0 0 0 1 1 1 1 1 0 0 0 0 0 1 5 1 0 0 0 0 1
1 0 0 0 0 1 1 0 1 1 0 0 0 0 1 0 0 0 1 0 0 0 0 1 1 0 1 1 0 0 0 1
1 0 0 1 0 1 0 0 0 1 0 0 3 1 1 0 0 0 1 1 1 0 0 1 0 0 0 1 0 0 0 1
1 0 1 0 0 1 0 0 0 1 0 1 3 0 1 0 0 0 1 0 1 1 0 1 0 0 0 1 0 0 0 1
1 0 0 0 0 1 1 4 1 1 0 0 0 0 1 1 1 1 1 0 0 0 0 1 1 4 1 1 0 0 0 1
3 3 3 3 3 3 3 3 3 3 3 3 3 3 3 3 3 3 3 1 1 1 1 1 1 1 1 1 1 1 1 1

