3 b b b b b b b b b b b b b b b b b b b b b b b b b b b b b b b
1 g g g s W W W W W W W W W W W W W W W W W W W W W W S g g G b
1 g g g s W l r W W W W W W W W W W W W W W W l r W W S g g G b
1 g g g s W W W W W W W W W W W W W W W W W W W W W W S g g G b
1 g g g s W W W W W W W W W W W W W W W W W W W W W W S g g G b
1 g g g s W W W W W W W W W W W W W W W W W W W W W W S g g G b
1 g g g s W W W W W W W W W W W W W W W W W W W W W W S g g G b
1 g g g s W W W W W W W W W W W W W W W W W W W W W W S g g G b
1 g g g s W W W W W W W W W W W W W W W W W W W W W W S g g G b
1 g g g s W W W W W W W W W W W W W W W W W W W W W W S g g G b
1 g g g P P P P P P P P P P P P P P P P P P P P P P P P g g G b
1 g g g B B B B B B B B B B B B B B B B B B B B B B B B g g G b
1 g g g B B B B B B B B B B B B B B B B B B B B B B B B g g G b
1 g g g B B B B B B B B B B B B B B B B B B B B B B B B g g G b
1 g g g p p p p p p p p p p p p p p p p p p p p p p p p g g G b
1 g g g s W W W W W W W W W W W W W W W W W W W W W W S g g G b
1 g g g s W W W W W W W W W W W W W W W W W W W W W W S g g G b
1 g g g s W W W W W W W W W W W W W W W W W W W W W W S g g G b
1 g g g s W W W W W W W W W W W W W W W W W W W W W W S g g G b
1 g g g s W W W W W W W W W W W W W W W W W W W W W W S g g G b
1 g g g s W W W W W W W W W W W W W W W W W W W W W W S g g G b
1 g g g s W W W W W W W W W W W W W W W W W W W W W W S g g G b
1 g g g s W W W W W W W W W W W W W W W W W W W W W W S g g G b
1 g g g s W u U W W W W W W W W W W W W W W W u U W W S g g G b
1 g g g s W d D W W W W W W W W W W W W W W W d D W W S g g G b
1 g g g s W W W W W W W W W W W W W W W W W W W W W W S g g G b
1 g g g s W W W W W W W W W W W W W W W W W W W W W W S g g G b
1 g g g s W W W W W W W W W W W W W W W W W W W W W W S g g G b
1 g g g s W W W W W W W W W W W W W W W W W W W W W W S g g G b
1 g g g s W W W W W W W W W W W W W W W W W W W W W W S g g G b
1 g g g s W W W W W W W W W W W W W W W W W W W W W W S g g G b
3 b b b b b b b b b b b b b b b b b b b b b b b b b b b b b b b

