3 b b b b b b b b b b b b b b b b b b b b b b b b b b b b b b b
1 g g g g g g g g g g g g g g g g g g g g g g g g g g g g g g b
1 g g g g g g g g g g g g g g g g g g g g g g g g g g g g g g b
1 g g g g g g g g g g g g g g g g g g g g g g g g g g g g g g b
1 g g g g g g g g g g g g g g g g g g g g g g g g g g g g g g b
1 g g g g g g g g g g g g g g g g g g g g g g g g g g g g g g b
1 g g g g g g g g g g g g g g g g g g g g g g g g g g g g g g b
1 g g g g g g g g g g g g g g g g g g g g g g g g g g g g g g b
1 g g g g g g g g g G g g g g g g g g g g g g g g g g g g g g b
1 g g g g G g g g g g g G g g g g g g g g G g g g g g g g g g b
1 g g g g g g g g g g g g g g g g g g g g g g g g g g g g g g b
1 g g g g g g g g g g g g g g g g g g g g g g g g g g g g g g b
1 g g g g g g g g g g g g g g g g g g g g g g g g g g g g g g b
1 g g g g g g g g g g g g g g g g g G g g g g g g g g g g g g b
1 1 3 G g g g g g g g G g g g g g g g g g G g g g g g g g g g b
1 g g g g g g g g g g g g g g g g g g g g g g g g g g g g g g b
1 3 3 g g g g G g g g g g g g g g g g g g g g G g g g g g g g b
1 g g g g g g g g g g g g g g g g g g g g g g g g g g g g g g b
1 g g g g g g g g g g g g g g g g g g g g g g g g g g g g g g b
1 g g g g g g g g g g g g G g g g g g G g g G g g g g g g g g b
1 g g g G g g g g g g g g g g g g g g g g g g g g g g g g g g b
1 g g g g g g g g g g g g g g g g g g g g g g G g g g g g g g b
1 g g g g g g g g g g g g g g g g g g g g g g g g g g g g g g b
1 g g g g g g g g g g g g g g g g g g g g g G g g g g g g g g b
1 g g g g g G g g g g g g g g g g g g g g g g G g g g g g g g b
1 g g g g g g g g g g G g g g g g g g g g g g g g g g g g g g b
1 g g g g g g g g g g g g g g g g g g g g g g g g G g g g g g b
1 g g g g g G g g g g g g g g g g g g g G g g g g g g g g g g b
1 g g g g g g g g g g g g g g g g g g g g g g g g g g g g g g b
1 g g g g g g g g g g g g g g G g g g g G g g g g g g g G g g b
1 g g g g g g g g g g g g g g g g g g g g g g g g g g g g g G b
3 b b b b b b b b b b b b b b b b b b b b b b b b b b b b b b b

